KOS	= "countries/Kosovo.txt"

# German RKS
RKP = "countries/RK_Polen.txt"
RKO = "countries/RK_Ostland.txt"
RKU = "countries/RK_Ukraine.txt"
RKR = "countries/RK_Russland.txt"
RKK = "countries/RK_Kaukasien.txt"
RKD = "countries/RK_Danemark.txt"
RKN = "countries/RK_Niederlande.txt"
RNO = "countries/RK_Norwegen.txt"
RKM = "countries/RK_Mittleafrika.txt"
SSW = "countries/SS_Serbia.txt"
#RKS = "countries/RK_Sudafrika.txt"
# French Algeria
FAL = "countries/French_Algeria.txt"

# Free france
FFA = "countries/Free_France.txt"

# Co-Prosperity Sphere puppets
AZH = "countries/Azad_Hind.txt"
SKI = "countries/Sikkim.txt"
ASS = "countries/Assam.txt"

#Burma Breakaway 
AKN = "countries/Arakan.txt"
CHN = "countries/Chin.txt"
KRN = "countries/Karen.txt"
MNO = "countries/Mon.txt"
SHN = "countries/Shan.txt"
KAH = "countries/Kachin.txt"
JBF = "countries/Japanese Force Burma.txt"
CBP = "countries/Communist Burma.txt"

# Russian Warlords
RAR = "countries/Red_Army_Reminants.txt"
CIA = "countries/NKVD.txt"
ROA = "countries/Russian_Liberation_Army.txt"
RRO = "countries/Russian_Religious_Order.txt"
RDC = "countries/Russian_Democratic_Council.txt"
RMU = "countries/Russian_Military_Union.txt"
SPE = "countries/Soviet_Peoples_Empire.txt"
DFR = "countries/Deutsche_Fliegerrettung.txt"
COD = "countries/Cult_of_Destruction.txt"
NEN = "countries/Nenetsia.txt"
BSK = "countries/Bashkortostan.txt"
ALT = "countries/Altay.txt"
MAG = "countries/Magnitogorsk.txt"
WSR = "countries/Western_Siberian_Republic.txt"

# Partisans
TCS = "countries/Transcaucasian_Partisans.txt"

# Misc tags
ANR = "countries/Anarchy.txt"
FAK = "countries/Fake.txt"